aba = abandoned
abd = abdomen
abi = ability
abl = able
abn = abnormal
abr = abroad
abs = absurd
acc = accept
ace = ace
ach = achieve
aci = acid
aco = acorn
acq = acquire
acr = acre
act = act
acu = acute
aer = aerial
afa = afar
aff = affect
afl = afloat
afo = afoot
afr = africa
aft = after
age = age
agg = aggressive
agh = aghast
agi = agile
agn = agnostic
ago = ago
agr = agree
ahe = ahead
aho = ahoy
aid = aid
aim = aim
aja = ajar
ala = alarm
alb = album
alf = alfred
alg = algebra
ali = alien
alk = alkaline
alm = almost
alo = alone
alp = alphabet
alr = alright
alt = alter
alu = aluminum
alw = always
ama = amazing
amb = amber
ame = america
ami = amid
amm = ammonia
amn = amnesty
amo = amount
amp = amplify
amu = amusing
ana = analyze
anc = anchor
and = and
ane = anemia
ang = angry
ani = animal
ank = ankle
ann = annex
ano = another
ans = answer
ant = ant
anv = anvil
any = any
aor = aorta
apa = apart
apo = apollo
app = app
apr = april
apt = apt
aqu = aquarium
arb = arbitrary
ard = ardently
are = area
arg = argentina
ari = aristocrat
arm = arm
aro = aroma
arr = arrow
ars = arson
art = art
asc = ascend
ash = ash
asi = asia
ask = ask
asl = asleep
asp = aspect
ast = astute
atl = atlas
ato = atom
atr = atrium
att = attach
aty = atypical
auc = auction
aud = audio
aug = august
aut = author
ava = avatar
ave = average
avi = aviator
avo = avoid
awa = award
awh = awhile
awk = awkward
awn = awning
awo = awoke
awr = awry
axi = axis
bab = baby
bac = back
bad = bad
baf = baffling
bag = bag
bak = baker
bal = ball
bam = bamboo
ban = ban
bar = bar
bas = bass
bat = bat
bau = bauble
baz = bazooka
bla = black
ble = blend
bli = blink
blo = blow
blu = blue
boa = boat
bob = bob
bod = body
bog = bogus
boi = boil
bol = bold
bon = bone
boo = book
bor = born
bos = boss
bot = both
bou = bounce
bov = bovine
box = box
bre = break
bri = brick
bro = brown
bru = brush
bub = bubble
buc = buck
bud = buddy
buf = buffer
bug = bug
bul = bull
bun = bunny
bus = bus
buz = buzz
cab = cable
cac = cactus
cad = caddy
cag = cage
cah = cahoots
cak = cake
cal = call
cam = camera
can = can
cap = cap
car = car
cas = cash
cat = cat
cau = caution
cav = cave
ced = cedar
cel = cell
cem = cement
cen = cent
cer = ceramic
ces = cesspool
cha = chat
che = chef
chi = chile
chl = chlorine
cho = chop
chr = chrome
chu = chuck
cid = cider
cil = cilantro
cin = cinnamon
cir = circle
cit = city
civ = civil
cla = claw
cle = clean
cli = clip
clo = clock
clu = club
coa = coal
cob = cobalt
coc = cocoa
cod = code
coe = coerce
cof = coffee
cog = cog
coh = coherent
coi = coin
cok = coke
col = cold
com = command
con = cone
cop = cop
cor = core
cos = cost
cot = cotton
cou = court
cov = cover
coy = coyote
coz = cozy
cra = crane
cre = create
cri = cringe
cro = crop
cru = crust
cry = cry
cub = cub
cuc = cucumber
cud = cuddle
cuf = cuff
cul = cult
cup = cup
cur = cure
cus = custom
cut = cut
cyc = cycle
cyl = cylinder
cym = cymbal
cyt = cytoplasm
dad = dad
daf = daffodil
dag = dagger
dai = daily
dal = dallas
dan = dance
dar = dark
das = dash
dat = data
dau = daughter
daw = dawn
day = day
daz = dazzling
dea = deal
deb = debt
dec = deck
ded = deduce
dee = deep
def = define
deg = degree
deh = dehydrate
dei = deity
dej = dejected
del = dell
dem = demo
den = deny
deo = deodorant
dep = depend
der = derived
des = desk
det = determination
deu = deutsch
dev = developer
dex = dexterity
dia = diary
dic = dice
dif = difference
dig = digit
dil = dilute
dim = dim
din = dinosaur
dio = dioxide
dip = dip
dir = dirt
dis = disk
dit = ditto
div = divide
diz = dizzy
doa = doable
doc = document
dod = dodge
doi = doing
dol = doll
dom = dominant
don = don
doo = doodle
dor = dork
dos = dose
dot = dot
dou = doubt
dov = dove
dow = down
doz = doze
dra = drag
dre = dream
dri = drive
dro = drop
dru = drum
dry = dry
dub = dubbed
duc = duct
dud = dude
duf = duff
dug = dug
duk = duke
dul = dull
dum = dumb
dup = duplicate
dur = duration
dus = dust
dut = duty
duv = duvet
dwa = dwarf
dwe = dwell
dwi = dwindle
dyn = dynamic
dys = dyslexia
eac = each
eag = eagle
ear = ear
eas = ease
eat = eat
eba = ebay
ebo = ebony
eca = ecard
ecc = eccentric
ech = echo
ecl = eclipse
eco = ecological
edg = edgy
edi = edit
edu = education
eel = eel
eff = effect
egg = egg
ego = ego
eit = either
eje = eject
ela = elastic
elb = elbow
eld = elder
ele = election
elf = elf
eli = elixir
ell = ellipse
elo = eloquent
els = else
elu = elude
elv = elves
ema = email
emb = embedded
emc = 
eme = emerald
emi = emit
emo = emotion
emp = empty
emu = emulate
ena = enable
enc = encode
end = end
ene = enemy
enf = enforce
eng = english
enh = enhance
eni = enigmatic
enj = enjoy
enl = enlarge
enq = enquiry
enr = enrage
ens = ensure
ent = entity
enu = enunciate
env = environment
enz = enzyme
epi = episode
equ = equal
era = era
erg = ergonomic
err = error
eru = erupt
esc = escape
esk = eskimo
eso = esophagus
esp = espresso
esq = esquire
ess = essay
est = established
etc = etc
ete = eternal
eth = ethical
eup = euphemism
eva = evaluate
eve = eve
evi = evident
evo = evolution
exa = examine
exc = excel
exe = execute
exf = exfoliate
exh = exhale
exi = exit
exo = exotic
exp = export
exq = exquisite
ext = extra
exu = exuberant
fab = fabric
fac = fact
fad = fade
fai = fair
fal = fall
fam = family
fan = fan
fas = fast
fau = fault
fav = favorite
fea = fear
fed = fed
fee = fee
fei = feisty
fel = fell
fem = female
fen = fence
fer = ferrari
fes = festival
fet = fetch
fev = fever
fib = fiber
fic = fiction
fid = fidget
fif = fifth
fig = fig
fil = fill
fin = fin
fis = fish
fit = fit
fiv = five
fla = flag
fle = flex
fli = flip
flo = flop
fly = fly
foa = foam
fog = fog
foi = foil
fol = follow
fon = font
foo = food
fos = fossil
fou = four
foy = foyer
fra = frame
fre = free
fri = friday
fro = from
fru = fruit
fry = fry
gab = gabriel
gaf = gaffe
gag = gag
gai = gain
gal = gal
gam = game
gan = gang
gap = gap
gar = gary
gas = gas
gat = gate
gau = gauge
gav = gave
gaw = gawk
gaz = gaze
gea = gear
gec = gecko
gee = geek
gei = geiger
gen = generate
geo = geology
ger = german
ges = gesture
get = get
gia = giant
gib = gibson
gid = giddy
gif = gif
gig = gig
gil = gill
gim = gimmick
gir = girl
giv = give
giz = gizmo
gla = glad
gle = glee
gli = glide
glo = glow
glu = glue
gna = gnarly
goa = goal
goe = goes
gog = goggles
goi = going
gol = gold
gon = gone
goo = good
gop = gopher
gor = gore
gos = gossip
got = got
gou = gourmet
gow = gown
gra = grab
gre = green
gri = grid
gro = grow
gru = grub
gua = guard
gui = guide
gul = gulf
gum = gum
gur = guru
gus = gust
gut = gut
guy = guy
guz = guzzler
gyr = gyration
hab = habit
hac = hack
hag = haggler
hai = haiti
hal = halo
ham = ham
han = hand
hap = happen
har = hard
has = has
hat = hat
hau = haunt
hav = have
haz = hazy
hea = head
hed = hedge
hef = hefty
hel = hell
hem = hemoglobin
hen = hen
her = her
hes = hesitate
hex = hexagon
hub = hub
hud = hudson
huf = huff
hug = hug
hul = hull
hum = hum
hun = hunt
hur = hurry
hus = husband
hyb = hybrid
hyd = hydrogen
hyp = hypnosis
ibu = ibuprofen
ice = ice
ici = icing
ick = icky
ico = icon
ide = idea
idi = idiom
idl = idle
igl = igloo
ign = ignore
igu = iguana
ill = ill
ima = image
imb = imbecile
imi = imitate
imm = immune
imp = imp
iod = iodine
ion = ion
ipa = ipad
iph = iphone
ipo = ipod
ira = iran
irk = irk
iro = iron
irr = irregular
isl = island
iso = isotope
iss = issue
ita = italy
ite = item
iti = itinerary
itu = itunes
ivo = ivory
jab = jab
jac = jack
jai = jail
jal = jalapeno
jam = jam
jan = january
jar = jar
jas = jason
jau = jaunt
jav = java
jaw = jaw
jay = jay
jaz = jazz
jee = jeep
jel = jelly
jer = jerry
jes = jesus
jet = jet
jif = jiffy
jig = jigsaw
jim = jim
jin = jingle
jit = jitter
job = job
joc = jockey
jog = jog
joh = john
joi = join
jok = joke
jol = jolly
jov = jovial
joy = joy
jub = jubilant
jud = judge
jug = jug
jui = juice
juj = jujitsu
juk = jukebox
jul = july
jum = jump
jun = june
jur = jury
jus = just
juv = juvenile
kab = kabob
kan = kangaroo
kar = karma
keb = kebab
kee = keen
kel = kelp
ken = ken
kep = kept
ker = kernel
ket = ketchup
kic = kick
kil = kill
kim = kim
kin = king
kis = kiss
kit = kit
kiw = kiwi
kle = klein
kna = knapsack
kne = knee
kni = knit
kno = know
koa = koala
koo = kooky
kos = kosher
kry = krypton
kud = kudos
kun = kung
lab = laboratory
lad = lady
lag = lag
lai = lair
lak = lake
lan = lane
lap = lap
lar = larry
las = last
lat = late
lau = launch
lav = lavender
lax = laxative
laz = lazy
lec = lecture
lef = left
leg = leg
lem = lemon
len = length
leo = leo
les = less
let = let
lev = level
lia = liar
lib = library
lic = lick
lif = life
lig = light
lik = like
lil = lil
lim = limit
lin = line
lio = lion
lip = lip
liq = liquid
lis = list
lit = lit
liv = live
liz = lizard
lub = lubricant
luc = luck
lud = ludicrous
lug = luggage
luk = luke
lul = lullaby
lum = lumber
lun = lunch
lur = lure
lus = lush
lux = luxury
lyi = lying
lyr = lyric
mac = macintosh
mag = magazine
mah = mahogany
mai = main
maj = major
mak = make
mal = mall
mam = mama
man = man
map = map
mar = march
mas = mass
mat = math
mau = maui
mav = maverick
max = maximum
may = may
moa = moan
mob = mob
moc = mock
mod = modification
moi = moist
mol = molar
mom = mom
mon = month
moo = moon
mor = more
mos = moss
mot = motion
mou = mouse
mov = move
mow = mow
muc = muck
mud = mud
mug = mug
mul = multiply
mum = mummy
mun = mundane
mup = muppet
mur = murder
mus = music
mut = mutable
muz = muzzle
mys = mystery
myt = myth
nac = nacho
nai = nail
nam = name
nan = nano
nap = nap
nar = narrow
nas = nasty
nat = natural
nau = nautical
nav = navigation
nea = neat
neb = nebula
nec = neck
neg = negate
nem = nemesis
neo = neo
nep = nepal
ner = nerve
nes = nest
net = net
neu = neuron
nev = never
nex = next
nib = nibble
nic = nick
nie = niece
nif = nifty
nim = nimble
nin = nine
nuc = nuclear
nug = nugget
nul = null
num = number
nup = nuptials
nur = nurse
nut = nut
nuz = nuzzle
nyl = nylon
oak = oak
oas = oasis
obe = obesity
obi = obituary
obj = object
obl = oblivion
obn = obnoxious
obo = oboe
obs = observe
obt = obtain
obv = obvious
occ = occur
oce = ocean
oct = octagon
ogl = ogle
oil = oil
oin = oink
oka = okay
old = old
oli = olive
oly = olympic
ome = omega
omi = omit
omn = omnivore
onb = onboard
onc = once
ong = ongoing
oni = onion
onl = online
ons = onset
ont = onto
onw = onward
ony = onyx
oop = 
ooz = ooze
opa = opacity
ope = open
opi = opinion
opo = opossum
opp = opponent
opt = option
opu = opulently
osm = osmosis
oth = other
ott = otter
ouc = 
oug = ought
oun = ounce
out = out
ova = oval
ove = over
owl = owl
oxf = oxford
oxi = oxide
oxy = oxygen
oys = oyster
ozo = ozone
pac = pack
pad = pad
pag = page
paj = pajamas
pal = pal
pam = pamela
pan = pan
pap = paper
par = part
pas = pass
pat = pat
pau = paul
pav = pavement
paw = paw
pay = pay
peb = pebble
pec = peculiar
ped = pedigree
peg = peg
pel = pellet
pen = pen
pep = pepper
per = peru
pes = pesky
pet = pet
pha = phase
pho = phone
phr = phrase
pla = plan
ple = please
pli = pliable
plo = plot
plu = plus
ply = plywood
poa = poach
pod = pod
poe = poem
pog = pogo
poi = poison
pok = pokemon
pol = poll
pon = pony
pop = pop
por = port
pos = position
pou = pound
pow = power
pra = prank
pre = previous
pri = print
pro = professional
pru = prune
psy = psychic
pub = pub
puc = pucker
pue = 
pul = pull
pum = puma
pun = pun
pup = puppy
pur = purr
pus = push
put = put
puz = puzzle
pyr = pyramid
pyt = python
qua = quack
que = query
qui = qui
quo = quote
rab = rabbit
rac = rack
rad = radar
raf = raft
rag = rage
rai = rail
rak = rake
ral = rally
ram = ram
ran = ran
rar = rare
ras = raspberry
rav = ravage
rea = read
reb = rebel
rec = record
ree = reed
ref = reference
reg = register
reh = rehab
rei = reiterate
rej = reject
rek = rekindle
rel = relative
rem = remove
ren = rent
reo = reopen
rep = repeat
req = request
rer = rerun
res = resource
ret = return
reu = reunion
rev = reverse
rew = reward
rhy = rhyme
rib = rib
ric = rick
rid = rid
rif = riff
rig = rig
rim = rim
rin = ring
rio = riot
rip = rip
ris = rise
rit = ritalin
riv = river
roa = road
rob = rob
roc = rock
rog = rogue
rom = rome
rop = rope
ros = rose
rot = rot
rou = round
rov = rover
roy = roy
rub = rub
ruc = ruckus
rud = rudder
rug = rug
rui = ruin
rul = rule
rum = rumble
run = run
rup = rupture
rur = rural
rus = rust
rut = 
sab = sabotage
sac = sacred
sad = sad
saf = safe
sag = saggy
sai = said
sak = sake
sal = salt
sam = sam
san = sans
sap = sap
sar = sara
sas = sassy
sat = saturday
sau = sauce
sav = save
sax = sax
say = say
sca = scan
sce = scene
sch = scheme
sci = science
sco = scope
scr = scrap
scu = scuba
sec = second
sed = sedate
seg = segment
sei = seismic
sel = sell
sem = semi
sen = send
sep = separate
seq = sequence
ser = server
ses = session
set = set
sev = seven
sha = shaft
she = she
shi = ship
sho = show
shr = shrug
shu = shun
shy = shy
sia = siamese
sib = sibling
sid = side
sie = sierra
sif = sift
sig = sign
sil = silent
sim = simulation
sin = sin
sir = sir
sis = sister
sit = sit
six = six
siz = size
ska = skate
ske = sketch
ski = ski
sky = sky
sla = slang
sle = sled
sli = slim
slo = slot
slu = slug
sma = small
sme = smell
smi = smile
smo = smoke
smu = smug
sna = snap
sne = sneak
sni = sniff
sno = snow
snu = snub
spe = specification
sph = sphere
spi = spin
spl = split
spo = spot
spr = spray
spu = spur
spy = spy
squ = squad
sta = star
ste = step
sti = still
sto = stop
str = string
stu = study
sty = style
sua = 
sub = subscribe
suc = suck
sud = sudden
suf = suffix
sug = sugar
sui = suit
sul = sulfur
sup = support
sur = surf
sus = suspicious
swa = swap
swe = sweden
swi = switch
swo = sword
swu = swung
syc = sycamore
sym = symbol
syn = sync
syr = syrup
sys = system
t-s = 
tab = tab
tac = tack
tad = tadpole
tae = taekwondo
tag = tag
tai = tail
tak = take
tal = tall
tam = tamper
tan = tan
tap = tap
tar = tar
tas = task
tat = tattoo
tau = taunt
tav = tavern
tha = thailand
the = theory
thi = think
tho = thorn
thr = three
thu = thursday
thw = thwart
thy = thy
tia = tiara
tib = tibia
tid = tidbit
tig = tiger
til = till
tim = tim
tin = tin
tip = tip
tir = tire
tis = tissue
tra = travel
tre = tree
tri = trio
tro = trophy
tru = true
try = try
tub = tub
tuc = tuck
tue = tuesday
tug = tug
tui = tuition
tul = tulip
tum = tummy
tur = turbo
tus = tusk
tut = tutorial
tux = tux
twe = tweet
twi = twin
tyc = tycoon
tyi = tying
tyk = 
udd = udder
ult = ultimate
umb = umbrella
ump = 
una = unable
unb = unblock
unc = uncle
und = undo
une = uneven
unf = unfair
ung = ungodly
unh = unholy
uni = universal
unj = unjustly
unk = unknown
unl = unlucky
unm = unmanaged
unn = unnamed
uno = unopened
unp = unpack
unq = unquote
unr = unread
uns = unsafe
unt = until
unu = unused
unv = unvalued
unw = unwanted
unz = unzip
upb = upbeat
upc = upcoming
upd = update
upf = upfront
upg = upgrade
uph = uphold
upl = upload
upo = upon
upp = upper
upr = uproar
ups = upset
upt = uptight
upw = upward
ura = uranium
urb = urban
urc = urchin
ure = 
urg = urge
uro = urology
usa = usa
use = use
ush = usher
usu = usual
ute = utensil
uti = utility
utm = utmost
uto = utopia
utt = utter
vac = vacant
vag = vague
val = value
van = van
vap = vapor
var = variable
vas = vast
vea = 
veg = vegan
veh = vehicle
vel = velocity
ven = venus
ver = version
ves = vest
vet = veterinary
vex = vex
via = viable
vib = vibration
vic = victory
vid = video
vie = view
vig = vigorous
vil = villain
vin = vintage
vio = violet
vip = vip
vir = virus
vis = visible
vit = vitamin
viv = vivid
vix = 
voc = vocal
voi = void
vol = volume
vot = vote
vou = voucher
vow = vow
voy = voyage
wac = wacky
waf = waffle
wag = wagon
wak = wake
wal = wall
wan = wand
was = was
wat = watt
wav = wave
wha = what
whe = where
whi = white
who = who
wic = wicked
wid = width
wie = wield
wif = wifi
wik = wiki
wil = will
wim = wimp
win = win
wip = wipe
wir = wire
wis = wisdom
wiz = wizard
wob = wobble
wol = wolf
wom = woman
woo = wool
wor = world
wou = wound
wov = woven
wra = wrap
wre = wreck
wri = write
wro = wrong
xbo = xbox
xer = xerox
yah = yahoo
yam = yamaha
yan = yang
yap = 
yar = yarn
yea = year
yel = yell
yes = yes
yid = 
yie = yield
yip = 
yo- = 
yod = yodel
yog = yoga
yon = 
yoy = yoyo
yum = yummy
zea = zealand
zeb = zebra
zep = zeppelin
zer = zero
zes = zesty
zig = zigzag
zip = zip
zod = zodiac
zom = zombie
zon = zone
zoo = zoo
aar = aardvark
abb = abbreviate
abh = abhorrence
abu = abuse
aby = abyss
aca = academy
aes = aesthetic
aga = again
alc = alchemy
als = also
anx = anxiety
apn = apnea
ara = arab
asb = asbestos
ase = aseptic
aso = asocial
asy = asylum
atm = atmosphere
aus = australia
aux = auxiliary
aza = 
boh = bohemian
caf = cafe
caj = 
cea = ceasefire
cui = cuisine
cyb = cyber
cyn = cynic
cyp = cyprus
dac = 
dib = 
eav = eavesdrop
ecs = ecstasy
eer = eerie
eno = enough
eti = etiquette
euc = eucalyptus
eul = eulogy
eut = euthanize
feb = february
feu = feudalist
fix = fix
foc = focus
gad = gadget
gey = geyser
gho = ghost
gly = glycerin
gno = gnome
gov = government
gue = guest
gym = gym
gyn = gynecology
hei = height
hya = 
hyg = hygiene
iri = irish
jag = jaguar
jea = jean
jeo = jeopardize
jez = 
jou = journal
kam = kamikaze
kay = kayak
kha = khaki
kio = kiosk
lei = leisure
lep = leprechaun
leu = leukemia
lew = lewd
lla = llama
lua = 
mae = 
moz = mozilla
myr = myriad
nef = nefarious
nei = neither
nir = nirvana
nui = nuisance
ocu = ocular
off = off
oft = often
oom = 
osc = oscar
ost = ostrich
peo = people
pew = pewter
phe = phenomenon
phy = physical
pne = pneumonia
pse = pseudo
rha = rhapsody
rhe = rhetoric
rhi = rhino
rhu = rhubarb
scy = scythe
sku = 
syl = syllable
tie = tie
tup = tupperware
tyr = tyrant
uny = unyielding
upk = upkeep
vog = vogue
vul = vulnerable
xyl = xylophone
yac = yacht
yup = 
zil = zillion
zir = zirconium
zuc = zucchini
for = for
wit = wit
you = you
not = not
all = all
new = new
hom = home
abo = above
sea = sea
but = but
our = our
one = one
inf = infinite
see = see
his = history
web = web
now = now
fir = fir
bee = bee
how = how
wer = were
som = some
its = itself
top = top
int = integer
buy = buy
add = add
mes = mess
bes = best
sof = soft
wel = well
hig = high
ord = order
nee = need
doe = doe
ful = full
way = way
hot = hot
mad = mad
mem = memory
ter = term
bef = before
typ = type
bec = become
loc = location
usi = using
dvd = dvd
bet = bet
lon = long
ind = index
bei = being
tod = today
tec = technology
sou = south
own = own
hou = hour
tot = total
him = him
nor = nor
big = big
med = medic
law = law
pic = picture
inc = increase
tex = texture
rat = rat
lov = love
tit = title
non = non
ins = instruction
too = too
low = low
yor = york
lea = leaf
tee = teen
roo = room
men = men
adv = advance
wes = west
loo = look
tea = tea
gay = gay
wee = week
nov = novel
air = air
tes = test
tax = tax
bel = bell
log = log
red = red
soc = sock
key = key
fie = field
few = few
nig = night
bui = build
war = war
mig = might
fut = future
spa = spa
sun = sun
mee = meet
mil = mile
ori = origin
arc = arc
faq = 
tel = tell
fur = fur
ass = asset
dav = dave
fun = fun
lot = lot
sol = sol
mea = mean
bea = bear
wea = weak
mic = microphone
url = 
bil = bill
hos = host
adu = adult
tic = ticket
kid = kid
min = minimum
eur = europe
tog = together
far = far
wei = weight
tow = tow
toy = toy
met = met
loa = load
sor = sorry
son = son
hol = hole
htm = 
los = loss
bra = bra
bit = bit
jap = japan
sum = sum
adm = admin
dog = dog
soo = soon
ben = ben
org = organization
tou = tour
hop = hop
rol = roll
jew = jew
bid = bid
mid = middle
inv = invite
wen = went
wed = wedding
inn = inn
pot = pot
cne = 
bed = bed
hil = hill
mex = mexico
nok = nokia
pai = pain
boy = boy
hor = horror
tol = toll
inp = input
bin = bin
ire = ireland
coo = cool
ads = ads
beh = behind
hit = hit
poo = pool
mis = miss
eye = eye
php = 
isb = 
beg = begin
ohi = ohio
fat = fat
mik = mike
pea = pea
tom = tom
lor = lord
bey = beyond
ten = ten
die = die
bib = biblical
lee = lee
pie = pie
nak = naked
tem = temperature
ora = orange
pin = pin
ini = initial
isr = israel
jon = jon
fue = fuel
wai = wait
poc = pocket
lou = loud
joe = joe
mer = mercy
hir = hire
ore = oregon
bir = bird
kon = kong
dam = dam
sex = sex
haw = hawaii
eig = eight
ale = alex
dak = dakota
mix = mix
hon = honey
ray = ray
lac = lack
iow = iowa
byt = byte
kor = korea
tor = torture
inj = injury
jos = josh
phi = phi
won = won
mia = mia
row = row
dua = dual
usd = 
okl = oklahoma
cis = cisco
ado = adopt
uta = utah
hid = hid
lay = lay
eri = eric
tay = taylor
pda = 
orl = orlando
bur = bury
syd = sydney
ink = ink
noi = noise
jef = jeff
kev = kevin
jor = jordan
bik = bike
ton = ton
soi = soil
edw = edward
bio = biology
ark = ark
gun = gun
ada = ada
nod = nod
hoc = hockey
bow = bow
pil = pill
cze = czech
ida = idaho
lod = lodge
mir = mirror
jen = jennifer
vat = vatican
pak = pakistan
egy = egypt
pit = pit
pov = poverty
pia = piano
mec = mechanical
rap = rap
tos = toss
rya = ryan
pmi = 
ber = berry
pee = pee
ing = ingredient
hob = hobby
biz = bizarre
mel = melbourne
wyo = wyoming
eps = epson
lie = lie
pip = pipe
sic = sick
tif = tiffany
vec = vector
inq = inquire
rho = rhode
cia = 
ron = ronald
awe = awesome
vbu = 
nel = nelson
ade = adequate
tio = 
piz = pizza
ukr = ukraine
mpe = 
lam = lamb
htt = 
nob = nobody
mit = mitchell
kei = keith
pio = pioneer
ath = athletic
fot = 
ams = amsterdam
tok = tokyo
nik = nike
afg = afghanistan
tob = tobacco
blv = 
odd = odd
kat = kate
flu = flu
iee = 
leb = lebanon
soa = soap
adj = adjust
xht = 
orc = orc
nca = 
hoo = hood
hew = 
hik = hike
nis = nissan
fus = fuss
tun = tune
bis = bishop
lyc = 
zdn = 
nos = nose
ocl = 
zim = zimbabwe
jua = juan
msg = 
cei = ceiling
pix = pixel
lyn = lynn
fak = fake
hdt = 
bom = bomb
kod = kodak
ted = ted
noo = noon
toi = toilet
lop = 
xan = xanax
meg = mega
ist = istanbul
oma = oman
heb = hebrew
dyi = dying
sop = sophisticated
scs = 
sov = soviet
tox = toxic
bah = bahamas
ecu = ecuador
bia = bias
kij = 
vii = 
bap = baptist
arn = arnold
arl = 
kuw = kuwait
hin = hint
bev = beverage
bic = bicycle
joa = joan
cow = cow
bry = bryan
fij = fiji
inl = inline
mye = 
sod = soda
edd = eddie
uga = uganda
adi = adidas
jpe = 
suz = suzuki
mcd = mcdonald
nuk = nuke
ina = inappropriate
gha = ghana
zop = 
zam = zambia
gmb = 
llo = 
maz = mazda
uru = uruguay
tyl = tyler
ugl = ugly
dun = duncan
fuj = fuji
god = god
hre = 
bai = bail
lex = lexical
eug = eugene
aur = aurora
inh = inherited
cig = cigarette
lob = lobby
nud = nude
kaz = kazakhstan
qat = qatar
cay = cayman
usg = 
emm = emma
rey = 
jil = jill
mya = myanmar
ack = acknowledge
pir = pirate
uzb = uzbekistan
acd = 
cum = cumulative
zsh = 
edm = edmonton
lui = luis
hie = hierarchy
jak = jake
lut = luther
sew = sew
aze = azerbaijan
acn = acne
nia = niagara
yem = yemen
tsu = tsunami
yal = yale
owe = owen
yuk = yukon
wiv = wives
oec = 
aub = auburn
hyu = hyundai
vam = vampire
nit = nitrogen
rwa = rwanda
vsn = 
msi = 
kru = kruger
aru = aruba
asu = asus
bum = bump
nvi = nvidia
inb = inbox
ede = eden
nom = nomination
mim = 
feo = 
laf = 
hay = hay
adr = adrenaline
zin = zinc
isa = isaac
abe = aberdeen
dyl = dylan
kyl = kyle
hep = heptagon
ido = idol
sbj = 
yug = yugoslavia
hee = heel
tah = 
vau = vault
fio = fiona
orb = orb
pax = 
nts = 
usp = 
jad = jade
fuz = fuzz
mrn = 
ero = erotic
awf = awful
cdn = 
mey = meyer
smt = 
ine = inexpensive
kur = kurt
kir = 
adw = adware
zol = 
vik = viking
bhu = bhutan
pik = pike
gzi = 
ctr = 
lao = laos
tsh = tshirt
